9 5 3
0 0 0 0 0
0 1 1 1 0
0 0 0 1 0
0 1 0 1 0
2 1 0 1 3
0 1 0 1 0
0 1 0 0 0
0 1 1 1 0
0 0 0 0 0
8 1
4 2 5 2
0 1 0 2 0 3
