7 6 4
0 0 0 0 0 0
0 1 1 1 1 0
0 0 0 0 0 0
2 1 1 1 1 3
0 0 0 0 0 0
0 1 1 1 1 0
0 0 0 0 0 0
0 1 0 2 0 3 0 4
2 1 2 2 2 3
4 1 4 2
6 1
