8 10 8
0 0 0 0 0 0 0 0 0 3
0 0 0 0 0 0 0 0 0 0
0 0 0 0 0 0 0 0 0 0
0 0 0 0 0 0 0 0 0 0
0 0 0 0 0 0 0 0 0 0
0 0 0 0 0 0 0 0 0 0
0 0 0 0 0 0 0 0 0 0
2 0 0 0 0 0 0 0 0 0
7 1 7 3 7 5 7 7
6 2 6 4 6 6 6 8
5 1 5 3 5 5 5 7
4 2 4 4 4 6 4 8
3 1 3 3 3 5 3 7
2 2 2 4 2 6 2 8
1 1 1 3 1 5 1 7
0 2 0 4 0 6 0 8
