9 9 7
0 0 0 0 0 0 0 0 3
0 1 1 1 0 1 1 1 0
0 1 1 1 0 1 1 1 0
0 1 1 1 0 1 1 1 0
0 0 0 0 0 0 0 0 0
0 1 1 1 0 1 1 1 0
0 1 1 1 0 1 1 1 0
0 1 1 1 0 1 1 1 0
2 0 0 0 0 0 0 0 0
8 4
4 4
8 8
4 8
4 0
0 0
0 4
