9 5 3
0 0 0 0 0
0 1 1 1 0
0 0 0 1 0
0 1 0 1 0
2 1 0 1 3
0 1 0 1 0
0 1 0 0 0
0 1 1 1 0
0 0 0 0 0
8 2
4 2
0 2
